CTR	Viễn thông
FOC	Viễn thông
FOX	Viễn thông
ABC	Viễn thông
TTN	Viễn thông
KLF	Dịch vụ tiêu dùng
PET	Dịch vụ tiêu dùng
FRT	Dịch vụ tiêu dùng
DGW	Dịch vụ tiêu dùng
MWG	Dịch vụ tiêu dùng
CEN	Dịch vụ tiêu dùng
AMD	Dịch vụ tiêu dùng
TNA	Dịch vụ tiêu dùng
LMH	Dịch vụ tiêu dùng
TTH	Dịch vụ tiêu dùng
AAT	Dịch vụ tiêu dùng
GMA	Dịch vụ tiêu dùng
PIT	Dịch vụ tiêu dùng
AST	Dịch vụ tiêu dùng
SID	Dịch vụ tiêu dùng
VTJ	Dịch vụ tiêu dùng
PSD	Dịch vụ tiêu dùng
KTC	Dịch vụ tiêu dùng
COM	Dịch vụ tiêu dùng
TMC	Dịch vụ tiêu dùng
BTT	Dịch vụ tiêu dùng
CMV	Dịch vụ tiêu dùng
BMF	Dịch vụ tiêu dùng
ABR	Dịch vụ tiêu dùng
CPH	Dịch vụ tiêu dùng
SFC	Dịch vụ tiêu dùng
BSC	Dịch vụ tiêu dùng
HFX	Dịch vụ tiêu dùng
HTM	Dịch vụ tiêu dùng
GCB	Dịch vụ tiêu dùng
HTC	Dịch vụ tiêu dùng
PIV	Dịch vụ tiêu dùng
T12	Dịch vụ tiêu dùng
THS	Dịch vụ tiêu dùng
VNB	Dịch vụ tiêu dùng
ADG	Dịch vụ tiêu dùng
INN	Dịch vụ tiêu dùng
EID	Dịch vụ tiêu dùng
EBS	Dịch vụ tiêu dùng
HTP	Dịch vụ tiêu dùng
STH	Dịch vụ tiêu dùng
NBE	Dịch vụ tiêu dùng
ALT	Dịch vụ tiêu dùng
BST	Dịch vụ tiêu dùng
SMN	Dịch vụ tiêu dùng
DAD	Dịch vụ tiêu dùng
STC	Dịch vụ tiêu dùng
EPH	Dịch vụ tiêu dùng
HEV	Dịch vụ tiêu dùng
SGD	Dịch vụ tiêu dùng
SED	Dịch vụ tiêu dùng
BDB	Dịch vụ tiêu dùng
CAB	Dịch vụ tiêu dùng
ADC	Dịch vụ tiêu dùng
BED	Dịch vụ tiêu dùng
DAE	Dịch vụ tiêu dùng
DNB	Dịch vụ tiêu dùng
FHS	Dịch vụ tiêu dùng
IBD	Dịch vụ tiêu dùng
ECI	Dịch vụ tiêu dùng
HAB	Dịch vụ tiêu dùng
IHK	Dịch vụ tiêu dùng
IPH	Dịch vụ tiêu dùng
IBN	Dịch vụ tiêu dùng
IN4	Dịch vụ tiêu dùng
LBE	Dịch vụ tiêu dùng
PNC	Dịch vụ tiêu dùng
QST	Dịch vụ tiêu dùng
TPH	Dịch vụ tiêu dùng
PTP	Dịch vụ tiêu dùng
SAP	Dịch vụ tiêu dùng
VPR	Dịch vụ tiêu dùng
VNX	Dịch vụ tiêu dùng
DAH	Dịch vụ tiêu dùng
VJC	Dịch vụ tiêu dùng
OCH	Dịch vụ tiêu dùng
VNG	Dịch vụ tiêu dùng
RGC	Dịch vụ tiêu dùng
TCT	Dịch vụ tiêu dùng
HVN	Dịch vụ tiêu dùng
CTC	Dịch vụ tiêu dùng
VTD	Dịch vụ tiêu dùng
DS3	Dịch vụ tiêu dùng
PDC	Dịch vụ tiêu dùng
BTV	Dịch vụ tiêu dùng
RIC	Dịch vụ tiêu dùng
DSN	Dịch vụ tiêu dùng
DLD	Dịch vụ tiêu dùng
TTT	Dịch vụ tiêu dùng
TSJ	Dịch vụ tiêu dùng
HES	Dịch vụ tiêu dùng
BCV	Dịch vụ tiêu dùng
DSP	Dịch vụ tiêu dùng
SGH	Dịch vụ tiêu dùng
DNT	Dịch vụ tiêu dùng
DXL	Dịch vụ tiêu dùng
HGT	Dịch vụ tiêu dùng
MAS	Dịch vụ tiêu dùng
GTT	Dịch vụ tiêu dùng
HOT	Dịch vụ tiêu dùng
NAS	Dịch vụ tiêu dùng
SHX	Dịch vụ tiêu dùng
MTC	Dịch vụ tiêu dùng
ONW	Dịch vụ tiêu dùng
STT	Dịch vụ tiêu dùng
TSD	Dịch vụ tiêu dùng
VTG	Dịch vụ tiêu dùng
VIR	Dịch vụ tiêu dùng
VTR	Dịch vụ tiêu dùng
CLX	Dịch vụ tiêu dùng
LBC	Dịch vụ tiêu dùng
TH1	Dịch vụ tiêu dùng
DAN	Dịch vụ tiêu dùng
PNG	Dịch vụ tiêu dùng
TOP	Dịch vụ tiêu dùng
VGT	Hàng tiêu dùng
FTM	Hàng tiêu dùng
TCM	Hàng tiêu dùng
GIL	Hàng tiêu dùng
SVD	Hàng tiêu dùng
NDT	Hàng tiêu dùng
PPH	Hàng tiêu dùng
TNG	Hàng tiêu dùng
TDT	Hàng tiêu dùng
ADS	Hàng tiêu dùng
PNJ	Hàng tiêu dùng
SGI	Hàng tiêu dùng
TTG	Hàng tiêu dùng
VGG	Hàng tiêu dùng
MSH	Hàng tiêu dùng
HTG	Hàng tiêu dùng
STK	Hàng tiêu dùng
GMC	Hàng tiêu dùng
AG1	Hàng tiêu dùng
GTD	Hàng tiêu dùng
HDM	Hàng tiêu dùng
LIX	Hàng tiêu dùng
TVT	Hàng tiêu dùng
HCB	Hàng tiêu dùng
BVN	Hàng tiêu dùng
M10	Hàng tiêu dùng
BDG	Hàng tiêu dùng
X20	Hàng tiêu dùng
BMG	Hàng tiêu dùng
DCG	Hàng tiêu dùng
HLT	Hàng tiêu dùng
A32	Hàng tiêu dùng
DM7	Hàng tiêu dùng
GTK	Hàng tiêu dùng
G20	Hàng tiêu dùng
HSM	Hàng tiêu dùng
LGM	Hàng tiêu dùng
HNI	Hàng tiêu dùng
MGG	Hàng tiêu dùng
MNB	Hàng tiêu dùng
PTG	Hàng tiêu dùng
HUG	Hàng tiêu dùng
MPT	Hàng tiêu dùng
NTT	Hàng tiêu dùng
NJC	Hàng tiêu dùng
SSF	Hàng tiêu dùng
TLI	Hàng tiêu dùng
SPB	Hàng tiêu dùng
VDM	Hàng tiêu dùng
VDN	Hàng tiêu dùng
TET	Hàng tiêu dùng
VTI	Hàng tiêu dùng
XPH	Hàng tiêu dùng
X26	Hàng tiêu dùng
HNG	Hàng tiêu dùng
SBT	Hàng tiêu dùng
PAN	Hàng tiêu dùng
TAR	Hàng tiêu dùng
BAF	Hàng tiêu dùng
VNM	Hàng tiêu dùng
SSN	Hàng tiêu dùng
MSN	Hàng tiêu dùng
IDI	Hàng tiêu dùng
KDC	Hàng tiêu dùng
SJF	Hàng tiêu dùng
LSS	Hàng tiêu dùng
CMX	Hàng tiêu dùng
VHC	Hàng tiêu dùng
DBC	Hàng tiêu dùng
HSL	Hàng tiêu dùng
QNS	Hàng tiêu dùng
AGM	Hàng tiêu dùng
ANV	Hàng tiêu dùng
AFX	Hàng tiêu dùng
HVA	Hàng tiêu dùng
VHE	Hàng tiêu dùng
CET	Hàng tiêu dùng
ACL	Hàng tiêu dùng
ILA	Hàng tiêu dùng
MCM	Hàng tiêu dùng
BNA	Hàng tiêu dùng
VNH	Hàng tiêu dùng
TID	Hàng tiêu dùng
CTP	Hàng tiêu dùng
MPC	Hàng tiêu dùng
VOC	Hàng tiêu dùng
APF	Hàng tiêu dùng
MLS	Hàng tiêu dùng
FMC	Hàng tiêu dùng
SJ1	Hàng tiêu dùng
VLC	Hàng tiêu dùng
HKT	Hàng tiêu dùng
BBC	Hàng tiêu dùng
ANT	Hàng tiêu dùng
MCH	Hàng tiêu dùng
THP	Hàng tiêu dùng
SLS	Hàng tiêu dùng
NHV	Hàng tiêu dùng
AAM	Hàng tiêu dùng
BCF	Hàng tiêu dùng
NSC	Hàng tiêu dùng
MML	Hàng tiêu dùng
KTS	Hàng tiêu dùng
CAT	Hàng tiêu dùng
MCF	Hàng tiêu dùng
CBS	Hàng tiêu dùng
NCS	Hàng tiêu dùng
CPA	Hàng tiêu dùng
SEA	Hàng tiêu dùng
CAN	Hàng tiêu dùng
TFC	Hàng tiêu dùng
TAC	Hàng tiêu dùng
ABT	Hàng tiêu dùng
DAT	Hàng tiêu dùng
PRO	Hàng tiêu dùng
PSL	Hàng tiêu dùng
VSN	Hàng tiêu dùng
HNF	Hàng tiêu dùng
HHC	Hàng tiêu dùng
AGX	Hàng tiêu dùng
ATA	Hàng tiêu dùng
AGF	Hàng tiêu dùng
ATS	Hàng tiêu dùng
AUM	Hàng tiêu dùng
BLF	Hàng tiêu dùng
APT	Hàng tiêu dùng
AVF	Hàng tiêu dùng
BKH	Hàng tiêu dùng
BHG	Hàng tiêu dùng
BMV	Hàng tiêu dùng
CAD	Hàng tiêu dùng
BLT	Hàng tiêu dùng
CCA	Hàng tiêu dùng
CFV	Hàng tiêu dùng
DMN	Hàng tiêu dùng
C22	Hàng tiêu dùng
CMF	Hàng tiêu dùng
CNA	Hàng tiêu dùng
CMN	Hàng tiêu dùng
FCC	Hàng tiêu dùng
FDG	Hàng tiêu dùng
EPC	Hàng tiêu dùng
FGL	Hàng tiêu dùng
FHN	Hàng tiêu dùng
HKB	Hàng tiêu dùng
FCS	Hàng tiêu dùng
GQN	Hàng tiêu dùng
HGA	Hàng tiêu dùng
HAF	Hàng tiêu dùng
HVG	Hàng tiêu dùng
IDP	Hàng tiêu dùng
HNM	Hàng tiêu dùng
IFS	Hàng tiêu dùng
JOS	Hàng tiêu dùng
LYF	Hàng tiêu dùng
ICF	Hàng tiêu dùng
KGM	Hàng tiêu dùng
LAF	Hàng tiêu dùng
KHS	Hàng tiêu dùng
NDF	Hàng tiêu dùng
NNQ	Hàng tiêu dùng
MXC	Hàng tiêu dùng
NSS	Hàng tiêu dùng
PCF	Hàng tiêu dùng
SEP	Hàng tiêu dùng
NGC	Hàng tiêu dùng
SAF	Hàng tiêu dùng
SCV	Hàng tiêu dùng
SCA	Hàng tiêu dùng
SGO	Hàng tiêu dùng
SPD	Hàng tiêu dùng
SGC	Hàng tiêu dùng
SPH	Hàng tiêu dùng
SPV	Hàng tiêu dùng
TS4	Hàng tiêu dùng
SNC	Hàng tiêu dùng
SSC	Hàng tiêu dùng
TCJ	Hàng tiêu dùng
TAN	Hàng tiêu dùng
VHF	Hàng tiêu dùng
VSF	Hàng tiêu dùng
VCF	Hàng tiêu dùng
VLF	Hàng tiêu dùng
TTF	Hàng tiêu dùng
KMR	Hàng tiêu dùng
EVE	Hàng tiêu dùng
DQC	Hàng tiêu dùng
PAC	Hàng tiêu dùng
SAV	Hàng tiêu dùng
MHL	Hàng tiêu dùng
MBG	Hàng tiêu dùng
SHI	Hàng tiêu dùng
ACG	Hàng tiêu dùng
KSD	Hàng tiêu dùng
RAL	Hàng tiêu dùng
TLG	Hàng tiêu dùng
NET	Hàng tiêu dùng
GTA	Hàng tiêu dùng
TV6	Hàng tiêu dùng
ASA	Hàng tiêu dùng
NHT	Hàng tiêu dùng
DCS	Hàng tiêu dùng
FBA	Hàng tiêu dùng
TAG	Hàng tiêu dùng
GDT	Hàng tiêu dùng
KTL	Hàng tiêu dùng
PID	Hàng tiêu dùng
PHN	Hàng tiêu dùng
XHC	Hàng tiêu dùng
TMW	Hàng tiêu dùng
NAF	Hàng tiêu dùng
SCD	Hàng tiêu dùng
BSL	Hàng tiêu dùng
SKH	Hàng tiêu dùng
BQB	Hàng tiêu dùng
SMB	Hàng tiêu dùng
HAV	Hàng tiêu dùng
SAB	Hàng tiêu dùng
HAT	Hàng tiêu dùng
SKV	Hàng tiêu dùng
HAD	Hàng tiêu dùng
WSB	Hàng tiêu dùng
BTB	Hàng tiêu dùng
BHN	Hàng tiêu dùng
QHW	Hàng tiêu dùng
BHK	Hàng tiêu dùng
BSQ	Hàng tiêu dùng
HBH	Hàng tiêu dùng
SB1	Hàng tiêu dùng
SKN	Hàng tiêu dùng
BSP	Hàng tiêu dùng
BHP	Hàng tiêu dùng
BBM	Hàng tiêu dùng
BSH	Hàng tiêu dùng
HNR	Hàng tiêu dùng
THB	Hàng tiêu dùng
HLB	Hàng tiêu dùng
VDL	Hàng tiêu dùng
VHI	Hàng tiêu dùng
SBL	Hàng tiêu dùng
VKD	Hàng tiêu dùng
VTL	Hàng tiêu dùng
VTB	Hàng tiêu dùng
GLT	Hàng tiêu dùng
BEL	Hàng tiêu dùng
NST	Hàng tiêu dùng
HJC	Hàng tiêu dùng
CLC	Hàng tiêu dùng
HLG	Hàng tiêu dùng
HHS	Hàng tiêu dùng
HAX	Hàng tiêu dùng
VKC	Hàng tiêu dùng
CSM	Hàng tiêu dùng
SRC	Hàng tiêu dùng
DAS	Hàng tiêu dùng
DRC	Hàng tiêu dùng
CTF	Hàng tiêu dùng
TMT	Hàng tiêu dùng
CMC	Hàng tiêu dùng
HTL	Hàng tiêu dùng
GGG	Hàng tiêu dùng
VMA	Hàng tiêu dùng
SVC	Hàng tiêu dùng
ROS	Công nghiệp
HBC	Công nghiệp
LCG	Công nghiệp
HUT	Công nghiệp
DST	Công nghiệp
VNE	Công nghiệp
VCG	Công nghiệp
CII	Công nghiệp
FCN	Công nghiệp
LIG	Công nghiệp
BCC	Công nghiệp
TTB	Công nghiệp
G36	Công nghiệp
MCG	Công nghiệp
PC1	Công nghiệp
HID	Công nghiệp
PXS	Công nghiệp
HT1	Công nghiệp
SDD	Công nghiệp
VGC	Công nghiệp
CDO	Công nghiệp
S99	Công nghiệp
C4G	Công nghiệp
CTI	Công nghiệp
FID	Công nghiệp
TLD	Công nghiệp
CTD	Công nghiệp
GKM	Công nghiệp
HVH	Công nghiệp
PXI	Công nghiệp
PXT	Công nghiệp
PHC	Công nghiệp
DPG	Công nghiệp
CVN	Công nghiệp
EVG	Công nghiệp
SVN	Công nghiệp
SD6	Công nghiệp
C69	Công nghiệp
BCE	Công nghiệp
SD9	Công nghiệp
SCG	Công nghiệp
CNT	Công nghiệp
PTC	Công nghiệp
VC9	Công nghiệp
BTN	Công nghiệp
SDP	Công nghiệp
VC7	Công nghiệp
CGV	Công nghiệp
DVG	Công nghiệp
KPF	Công nghiệp
MST	Công nghiệp
VC2	Công nghiệp
CRC	Công nghiệp
VTV	Công nghiệp
HOM	Công nghiệp
L18	Công nghiệp
VC1	Công nghiệp
CMS	Công nghiệp
L14	Công nghiệp
AMS	Công nghiệp
UDC	Công nghiệp
BOT	Công nghiệp
SDT	Công nghiệp
NHA	Công nghiệp
DHA	Công nghiệp
VCC	Công nghiệp
VLB	Công nghiệp
SD3	Công nghiệp
HTN	Công nghiệp
VE9	Công nghiệp
KDM	Công nghiệp
C47	Công nghiệp
DTD	Công nghiệp
VMC	Công nghiệp
DC4	Công nghiệp
UDJ	Công nghiệp
NXT	Công nghiệp
C32	Công nghiệp
TL4	Công nghiệp
LUT	Công nghiệp
HU4	Công nghiệp
V21	Công nghiệp
SD5	Công nghiệp
SCI	Công nghiệp
NTP	Công nghiệp
PTB	Công nghiệp
TCR	Công nghiệp
L12	Công nghiệp
MCO	Công nghiệp
MVC	Công nghiệp
SPI	Công nghiệp
HDA	Công nghiệp
XMC	Công nghiệp
CI5	Công nghiệp
TKC	Công nghiệp
DGT	Công nghiệp
V12	Công nghiệp
BMP	Công nghiệp
FIC	Công nghiệp
SD4	Công nghiệp
DID	Công nghiệp
ACC	Công nghiệp
TA9	Công nghiệp
L43	Công nghiệp
HTE	Công nghiệp
NAG	Công nghiệp
DXV	Công nghiệp
NDX	Công nghiệp
NNC	Công nghiệp
THG	Công nghiệp
VCS	Công nghiệp
SCJ	Công nghiệp
DIH	Công nghiệp
HVX	Công nghiệp
HU3	Công nghiệp
TXM	Công nghiệp
BTS	Công nghiệp
SCL	Công nghiệp
DTC	Công nghiệp
HTI	Công nghiệp
VC6	Công nghiệp
PDB	Công nghiệp
QNC	Công nghiệp
SJM	Công nghiệp
CDC	Công nghiệp
TTL	Công nghiệp
HUB	Công nghiệp
ICG	Công nghiệp
HAN	Công nghiệp
SD7	Công nghiệp
SD2	Công nghiệp
PCC	Công nghiệp
VE1	Công nghiệp
LIC	Công nghiệp
GMX	Công nghiệp
HMS	Công nghiệp
KTT	Công nghiệp
S55	Công nghiệp
C92	Công nghiệp
CHS	Công nghiệp
VCX	Công nghiệp
DFF	Công nghiệp
VE3	Công nghiệp
PSB	Công nghiệp
BAX	Công nghiệp
CIP	Công nghiệp
VSE	Công nghiệp
VHD	Công nghiệp
CVT	Công nghiệp
HPP	Công nghiệp
DNP	Công nghiệp
CEE	Công nghiệp
E29	Công nghiệp
ICI	Công nghiệp
LM8	Công nghiệp
CCM	Công nghiệp
SJG	Công nghiệp
L45	Công nghiệp
SZB	Công nghiệp
NAV	Công nghiệp
SIG	Công nghiệp
VIT	Công nghiệp
VE8	Công nghiệp
VHH	Công nghiệp
VHL	Công nghiệp
HU1	Công nghiệp
HFB	Công nghiệp
VXB	Công nghiệp
RCC	Công nghiệp
DC2	Công nghiệp
HAS	Công nghiệp
PEN	Công nghiệp
TLT	Công nghiệp
TMX	Công nghiệp
LG9	Công nghiệp
DCR	Công nghiệp
QCC	Công nghiệp
CQT	Công nghiệp
ICN	Công nghiệp
CC1	Công nghiệp
SJE	Công nghiệp
HCC	Công nghiệp
VTA	Công nghiệp
LBM	Công nghiệp
VSI	Công nghiệp
DSG	Công nghiệp
HAM	Công nghiệp
TTC	Công nghiệp
CC4	Công nghiệp
CLH	Công nghiệp
MDG	Công nghiệp
SDJ	Công nghiệp
GAB	Công nghiệp
CT6	Công nghiệp
TS3	Công nghiệp
HSP	Công nghiệp
TA3	Công nghiệp
LMI	Công nghiệp
CID	Công nghiệp
DXD	Công nghiệp
TVA	Công nghiệp
ACE	Công nghiệp
CDR	Công nghiệp
SCC	Công nghiệp
GND	Công nghiệp
VIW	Công nghiệp
H11	Công nghiệp
L61	Công nghiệp
DC1	Công nghiệp
GTH	Công nghiệp
L35	Công nghiệp
S72	Công nghiệp
DND	Công nghiệp
SC5	Công nghiệp
SDN	Công nghiệp
UIC	Công nghiệp
CMD	Công nghiệp
KCE	Công nghiệp
TS5	Công nghiệp
BTD	Công nghiệp
LHC	Công nghiệp
PTO	Công nghiệp
ADP	Công nghiệp
ATB	Công nghiệp
BDT	Công nghiệp
EME	Công nghiệp
ACS	Công nghiệp
ALV	Công nghiệp
B82	Công nghiệp
BHT	Công nghiệp
BT6	Công nghiệp
CDG	Công nghiệp
BHC	Công nghiệp
BMN	Công nghiệp
C12	Công nghiệp
CCV	Công nghiệp
C36	Công nghiệp
CH5	Công nghiệp
CT3	Công nghiệp
CTA	Công nghiệp
CE1	Công nghiệp
CHC	Công nghiệp
CT5	Công nghiệp
CTN	Công nghiệp
CTX	Công nghiệp
CYC	Công nghiệp
DBH	Công nghiệp
DCT	Công nghiệp
CX8	Công nghiệp
DAC	Công nghiệp
DIC	Công nghiệp
DPS	Công nghiệp
DTV	Công nghiệp
E12	Công nghiệp
GTS	Công nghiệp
DCF	Công nghiệp
DT4	Công nghiệp
DX2	Công nghiệp
GH3	Công nghiệp
HC3	Công nghiệp
HEC	Công nghiệp
KHL	Công nghiệp
HC1	Công nghiệp
HCI	Công nghiệp
HLY	Công nghiệp
ICC	Công nghiệp
I10	Công nghiệp
L10	Công nghiệp
L44	Công nghiệp
LCS	Công nghiệp
KSK	Công nghiệp
L40	Công nghiệp
LCC	Công nghiệp
LGC	Công nghiệp
LM3	Công nghiệp
LQN	Công nghiệp
MCI	Công nghiệp
MEC	Công nghiệp
LO5	Công nghiệp
MCC	Công nghiệp
MEG	Công nghiệp
MES	Công nghiệp
PCM	Công nghiệp
PLE	Công nghiệp
PSG	Công nghiệp
MCT	Công nghiệp
NHC	Công nghiệp
PHH	Công nghiệp
PQN	Công nghiệp
PTE	Công nghiệp
PVH	Công nghiệp
PXC	Công nghiệp
PTD	Công nghiệp
PVA	Công nghiệp
PVV	Công nghiệp
PX1	Công nghiệp
PVX	Công nghiệp
QHD	Công nghiệp
QTC	Công nghiệp
S12	Công nghiệp
PXM	Công nghiệp
QLD	Công nghiệp
RCD	Công nghiệp
S27	Công nghiệp
S74	Công nghiệp
SD1	Công nghiệp
SDB	Công nghiệp
SDX	Công nghiệp
S96	Công nghiệp
SD8	Công nghiệp
SDY	Công nghiệp
SHG	Công nghiệp
SJC	Công nghiệp
TB8	Công nghiệp
TBX	Công nghiệp
SDH	Công nghiệp
SIC	Công nghiệp
TA6	Công nghiệp
TBT	Công nghiệp
TDF	Công nghiệp
TRT	Công nghiệp
VC5	Công nghiệp
TCK	Công nghiệp
TNM	Công nghiệp
TVG	Công nghiệp
V15	Công nghiệp
V11	Công nghiệp
VE4	Công nghiệp
VIH	Công nghiệp
VPC	Công nghiệp
VE2	Công nghiệp
VES	Công nghiệp
VMI	Công nghiệp
VTS	Công nghiệp
VVN	Công nghiệp
X77	Công nghiệp
XLV	Công nghiệp
YBC	Công nghiệp
VW3	Công nghiệp
XDH	Công nghiệp
XMD	Công nghiệp
HHV	Công nghiệp
DL1	Công nghiệp
MHC	Công nghiệp
VOS	Công nghiệp
HAH	Công nghiệp
VTO	Công nghiệp
PVT	Công nghiệp
GMD	Công nghiệp
HHG	Công nghiệp
MAC	Công nghiệp
SKG	Công nghiệp
SGP	Công nghiệp
TCD	Công nghiệp
HRT	Công nghiệp
VSC	Công nghiệp
VIP	Công nghiệp
PVP	Công nghiệp
TTZ	Công nghiệp
SRT	Công nghiệp
TCO	Công nghiệp
VNA	Công nghiệp
ASG	Công nghiệp
DXP	Công nghiệp
GSP	Công nghiệp
VTP	Công nghiệp
PHP	Công nghiệp
HMH	Công nghiệp
TOT	Công nghiệp
VLG	Công nghiệp
PGT	Công nghiệp
CAG	Công nghiệp
ACV	Công nghiệp
TCL	Công nghiệp
PSP	Công nghiệp
ILB	Công nghiệp
VNS	Công nghiệp
SWC	Công nghiệp
SCS	Công nghiệp
TMS	Công nghiệp
CIA	Công nghiệp
HTV	Công nghiệp
PDV	Công nghiệp
GIC	Công nghiệp
PSC	Công nghiệp
DVP	Công nghiệp
PTS	Công nghiệp
SFI	Công nghiệp
STG	Công nghiệp
PCT	Công nghiệp
VNL	Công nghiệp
SGN	Công nghiệp
PJT	Công nghiệp
CDN	Công nghiệp
VMS	Công nghiệp
SSG	Công nghiệp
VFC	Công nghiệp
TCW	Công nghiệp
CQN	Công nghiệp
VSM	Công nghiệp
CLL	Công nghiệp
CCR	Công nghiệp
SAS	Công nghiệp
SHC	Công nghiệp
NCT	Công nghiệp
BLN	Công nghiệp
IST	Công nghiệp
DVC	Công nghiệp
VIN	Công nghiệp
DOP	Công nghiệp
VGP	Công nghiệp
VNF	Công nghiệp
EMS	Công nghiệp
TOS	Công nghiệp
VPA	Công nghiệp
QLT	Công nghiệp
PTT	Công nghiệp
HNT	Công nghiệp
BSG	Công nghiệp
VSA	Công nghiệp
SGS	Công nghiệp
CCP	Công nghiệp
PAP	Công nghiệp
TJC	Công nghiệp
WCS	Công nghiệp
DAR	Công nghiệp
VFR	Công nghiệp
MVN	Công nghiệp
BXT	Công nghiệp
CMP	Công nghiệp
DDH	Công nghiệp
PJC	Công nghiệp
CCT	Công nghiệp
CPI	Công nghiệp
DDM	Công nghiệp
DNL	Công nghiệp
HCT	Công nghiệp
HHR	Công nghiệp
HNB	Công nghiệp
DSV	Công nghiệp
HHN	Công nghiệp
HTH	Công nghiệp
HTR	Công nghiệp
ISG	Công nghiệp
NOS	Công nghiệp
PDN	Công nghiệp
HLR	Công nghiệp
ILS	Công nghiệp
NAP	Công nghiệp
NWT	Công nghiệp
PNP	Công nghiệp
PSN	Công nghiệp
SAC	Công nghiệp
PLO	Công nghiệp
PRC	Công nghiệp
PTH	Công nghiệp
RAT	Công nghiệp
QSP	Công nghiệp
STS	Công nghiệp
TPS	Công nghiệp
TRS	Công nghiệp
SAL	Công nghiệp
TNP	Công nghiệp
TR1	Công nghiệp
TSG	Công nghiệp
TUG	Công nghiệp
VNT	Công nghiệp
VSP	Công nghiệp
VTM	Công nghiệp
VGR	Công nghiệp
VSG	Công nghiệp
VTX	Công nghiệp
VXT	Công nghiệp
VST	Công nghiệp
WTC	Công nghiệp
GEX	Công nghiệp
DDG	Công nghiệp
TGP	Công nghiệp
DHP	Công nghiệp
PPS	Công nghiệp
CAV	Công nghiệp
VBH	Công nghiệp
THI	Công nghiệp
VEC	Công nghiệp
KIP	Công nghiệp
EMC	Công nghiệp
TYA	Công nghiệp
AME	Công nghiệp
HLS	Công nghiệp
HEM	Công nghiệp
CJC	Công nghiệp
EMG	Công nghiệp
TSB	Công nghiệp
VTH	Công nghiệp
BTH	Công nghiệp
TBD	Công nghiệp
TNI	Công nghiệp
PVM	Công nghiệp
DZM	Công nghiệp
L63	Công nghiệp
SDK	Công nghiệp
REE	Công nghiệp
VEA	Công nghiệp
LLM	Công nghiệp
SRF	Công nghiệp
LM7	Công nghiệp
CTB	Công nghiệp
CEG	Công nghiệp
CTT	Công nghiệp
FSO	Công nghiệp
FT1	Công nghiệp
APL	Công nghiệp
CMK	Công nghiệp
FBC	Công nghiệp
IME	Công nghiệp
LCD	Công nghiệp
SCO	Công nghiệp
HDO	Công nghiệp
L62	Công nghiệp
MA1	Công nghiệp
PMS	Công nghiệp
MIE	Công nghiệp
UEM	Công nghiệp
SCY	Công nghiệp
YEG	Công nghiệp
HEJ	Công nghiệp
LPT	Công nghiệp
INC	Công nghiệp
TV3	Công nghiệp
TV2	Công nghiệp
SDA	Công nghiệp
VGV	Công nghiệp
SHN	Công nghiệp
VEF	Công nghiệp
SFN	Công nghiệp
ILC	Công nghiệp
TV4	Công nghiệp
HIZ	Công nghiệp
VCM	Công nghiệp
CFM	Công nghiệp
BUD	Công nghiệp
VWS	Công nghiệp
DKC	Công nghiệp
DUS	Công nghiệp
SDC	Công nghiệp
ARM	Công nghiệp
DCH	Công nghiệp
DKH	Công nghiệp
HGC	Công nghiệp
HLE	Công nghiệp
HTK	Công nghiệp
FTI	Công nghiệp
HGR	Công nghiệp
HSA	Công nghiệp
MPY	Công nghiệp
MQB	Công nghiệp
NAC	Công nghiệp
PVE	Công nghiệp
SON	Công nghiệp
MTB	Công nghiệp
PPE	Công nghiệp
QNT	Công nghiệp
SVL	Công nghiệp
TEC	Công nghiệp
TVH	Công nghiệp
UPC	Công nghiệp
VCT	Công nghiệp
TV1	Công nghiệp
TVM	Công nghiệp
USC	Công nghiệp
VQC	Công nghiệp
VNC	Công nghiệp
GTN	Công nghiệp
SMA	Công nghiệp
STP	Công nghiệp
PMP	Công nghiệp
BAL	Công nghiệp
BBH	Công nghiệp
NNG	Công nghiệp
PBP	Công nghiệp
BPC	Công nghiệp
DAP	Công nghiệp
BBS	Công nghiệp
BTG	Công nghiệp
DLT	Công nghiệp
HBD	Công nghiệp
HPB	Công nghiệp
SDG	Công nghiệp
BXH	Công nghiệp
DPC	Công nghiệp
HKP	Công nghiệp
NHP	Công nghiệp
SPA	Công nghiệp
VBC	Công nghiệp
MCP	Công nghiệp
PBT	Công nghiệp
SPP	Công nghiệp
TTP	Công nghiệp
TKA	Công nghiệp
SSI	Tài chính
SHS	Tài chính
ART	Tài chính
APG	Tài chính
TVS	Tài chính
SBS	Tài chính
VND	Tài chính
VIX	Tài chính
HCM	Tài chính
TCI	Tài chính
APS	Tài chính
ORS	Tài chính
VCI	Tài chính
VIG	Tài chính
AGR	Tài chính
CTS	Tài chính
MBS	Tài chính
FTS	Tài chính
BSI	Tài chính
TVB	Tài chính
EVS	Tài chính
VDS	Tài chính
PSI	Tài chính
BMS	Tài chính
BVS	Tài chính
IVS	Tài chính
AAS	Tài chính
HBS	Tài chính
VFS	Tài chính
WSS	Tài chính
HAC	Tài chính
CSI	Tài chính
DSC	Tài chính
PHS	Tài chính
HAG	Tài chính
FLC	Tài chính
ITA	Tài chính
LDG	Tài chính
CEO	Tài chính
NLG	Tài chính
HQC	Tài chính
DLG	Tài chính
TCH	Tài chính
SCR	Tài chính
KBC	Tài chính
FIT	Tài chính
VHG	Tài chính
VRE	Tài chính
DXG	Tài chính
VHM	Tài chính
PDR	Tài chính
DIG	Tài chính
ASM	Tài chính
IJC	Tài chính
HAR	Tài chính
DRH	Tài chính
NTL	Tài chính
ITC	Tài chính
NBB	Tài chính
KDH	Tài chính
VPH	Tài chính
BII	Tài chính
IDC	Tài chính
QCG	Tài chính
OGC	Tài chính
CCL	Tài chính
CRE	Tài chính
VPI	Tài chính
NDN	Tài chính
TDC	Tài chính
PVL	Tài chính
LGL	Tài chính
CKG	Tài chính
PTL	Tài chính
VIC	Tài chính
NVL	Tài chính
AAV	Tài chính
KHG	Tài chính
HPX	Tài chính
TIG	Tài chính
IDJ	Tài chính
NRC	Tài chính
PFL	Tài chính
SZC	Tài chính
AGG	Tài chính
HDG	Tài chính
BCM	Tài chính
THD	Tài chính
CIG	Tài chính
API	Tài chính
PV2	Tài chính
KOS	Tài chính
VCR	Tài chính
KSF	Tài chính
D2D	Tài chính
HDC	Tài chính
SSH	Tài chính
VRC	Tài chính
SGR	Tài chính
FIR	Tài chính
TEG	Tài chính
VC3	Tài chính
LHG	Tài chính
TIP	Tài chính
DXS	Tài chính
PWA	Tài chính
DTA	Tài chính
HLD	Tài chính
SJS	Tài chính
HD6	Tài chính
CSC	Tài chính
C21	Tài chính
TN1	Tài chính
D11	Tài chính
HU6	Tài chính
SNZ	Tài chính
BVL	Tài chính
IDV	Tài chính
EIN	Tài chính
NTC	Tài chính
SIP	Tài chính
PLA	Tài chính
HD2	Tài chính
SZL	Tài chính
HD8	Tài chính
TIX	Tài chính
NVT	Tài chính
MH3	Tài chính
KHA	Tài chính
VRG	Tài chính
PNT	Tài chính
CLG	Tài chính
DTI	Tài chính
CCI	Tài chính
DLR	Tài chính
EFI	Tài chính
FDC	Tài chính
HRB	Tài chính
KAC	Tài chính
HPI	Tài chính
HTT	Tài chính
LEC	Tài chính
PPI	Tài chính
LAI	Tài chính
NTB	Tài chính
PVR	Tài chính
PXA	Tài chính
RCL	Tài chính
STL	Tài chính
PXL	Tài chính
SDU	Tài chính
TBH	Tài chính
VNI	Tài chính
SZG	Tài chính
TDH	Tài chính
SHB	Tài chính
ABB	Tài chính
VPB	Tài chính
HDB	Tài chính
TCB	Tài chính
LPB	Tài chính
TPB	Tài chính
CTG	Tài chính
STB	Tài chính
MSB	Tài chính
MBB	Tài chính
SSB	Tài chính
EIB	Tài chính
VAB	Tài chính
OCB	Tài chính
ACB	Tài chính
BID	Tài chính
VIB	Tài chính
VCB	Tài chính
BVB	Tài chính
EVF	Tài chính
NVB	Tài chính
NAB	Tài chính
PGB	Tài chính
KLB	Tài chính
SGB	Tài chính
BAB	Tài chính
VBB	Tài chính
BVH	Tài chính
MIG	Tài chính
AIC	Tài chính
PGI	Tài chính
BLI	Tài chính
BMI	Tài chính
VNR	Tài chính
BIC	Tài chính
PTI	Tài chính
ABI	Tài chính
BCG	Tài chính
TGG	Tài chính
IPA	Tài chính
TVC	Tài chính
IBC	Tài chính
PVI	Tài chính
PRE	Tài chính
SAM	Công nghệ
ITD	Công nghệ
ONE	Công nghệ
ST8	Công nghệ
SMT	Công nghệ
VTK	Công nghệ
VGI	Công nghệ
ICT	Công nghệ
CMG	Công nghệ
TIE	Công nghệ
UNI	Công nghệ
VTE	Công nghệ
MFS	Công nghệ
VIE	Công nghệ
HIG	Công nghệ
POT	Công nghệ
PMT	Công nghệ
KST	Công nghệ
PMJ	Công nghệ
CKV	Công nghệ
LTC	Công nghệ
TEL	Công nghệ
TST	Công nghệ
VTC	Công nghệ
SRA	Công nghệ
SGT	Công nghệ
CMT	Công nghệ
HNE	Công nghệ
PIA	Công nghệ
SBD	Công nghệ
FPT	Công nghệ
ELC	Công nghệ
SRB	Công nghệ
HPT	Công nghệ
VLA	Công nghệ
DVN	Y tế
DCL	Y tế
DHG	Y tế
DBD	Y tế
PPP	Y tế
DMC	Y tế
DDN	Y tế
PBC	Y tế
DBT	Y tế
CDP	Y tế
VMD	Y tế
MKP	Y tế
SPM	Y tế
MED	Y tế
HDP	Y tế
IMP	Y tế
AGP	Y tế
DHT	Y tế
TRA	Y tế
BCP	Y tế
DTP	Y tế
OPC	Y tế
LDP	Y tế
DP3	Y tế
CNC	Y tế
BIO	Y tế
DTG	Y tế
VET	Y tế
DP1	Y tế
PMC	Y tế
TVP	Y tế
DBM	Y tế
DHD	Y tế
DP2	Y tế
DPP	Y tế
DHN	Y tế
DPH	Y tế
MTP	Y tế
NDP	Y tế
MKV	Y tế
NDC	Y tế
NTF	Y tế
TW3	Y tế
VDP	Y tế
VXP	Y tế
UPH	Y tế
VNY	Y tế
YTC	Y tế
JVC	Y tế
TNH	Y tế
AMP	Y tế
MEF	Y tế
TTD	Y tế
AMV	Y tế
DNM	Y tế
BBT	Y tế
MRF	Y tế
APH	Vật liệu cơ bản
DPM	Vật liệu cơ bản
HAI	Vật liệu cơ bản
GVR	Vật liệu cơ bản
HII	Vật liệu cơ bản
DRI	Vật liệu cơ bản
AAA	Vật liệu cơ bản
DCM	Vật liệu cơ bản
TSC	Vật liệu cơ bản
QBS	Vật liệu cơ bản
ABS	Vật liệu cơ bản
LAS	Vật liệu cơ bản
DAG	Vật liệu cơ bản
DGC	Vật liệu cơ bản
PLP	Vật liệu cơ bản
DDV	Vật liệu cơ bản
PHR	Vật liệu cơ bản
CSV	Vật liệu cơ bản
SBV	Vật liệu cơ bản
HCD	Vật liệu cơ bản
PLC	Vật liệu cơ bản
LTG	Vật liệu cơ bản
BFC	Vật liệu cơ bản
NHH	Vật liệu cơ bản
DPR	Vật liệu cơ bản
RDP	Vật liệu cơ bản
TDP	Vật liệu cơ bản
APC	Vật liệu cơ bản
SVG	Vật liệu cơ bản
VTZ	Vật liệu cơ bản
PSW	Vật liệu cơ bản
PMB	Vật liệu cơ bản
PSE	Vật liệu cơ bản
PCE	Vật liệu cơ bản
SFG	Vật liệu cơ bản
VNP	Vật liệu cơ bản
PGN	Vật liệu cơ bản
SPC	Vật liệu cơ bản
VPS	Vật liệu cơ bản
CPC	Vật liệu cơ bản
APP	Vật liệu cơ bản
BRC	Vật liệu cơ bản
TPC	Vật liệu cơ bản
RTB	Vật liệu cơ bản
NFC	Vật liệu cơ bản
HVT	Vật liệu cơ bản
SBR	Vật liệu cơ bản
VFG	Vật liệu cơ bản
TPP	Vật liệu cơ bản
DRG	Vật liệu cơ bản
VAF	Vật liệu cơ bản
GER	Vật liệu cơ bản
HRC	Vật liệu cơ bản
BT1	Vật liệu cơ bản
DHB	Vật liệu cơ bản
BRR	Vật liệu cơ bản
CGL	Vật liệu cơ bản
DPD	Vật liệu cơ bản
HNP	Vật liệu cơ bản
DOC	Vật liệu cơ bản
DTT	Vật liệu cơ bản
HPH	Vật liệu cơ bản
HSI	Vật liệu cơ bản
LNC	Vật liệu cơ bản
RBC	Vật liệu cơ bản
IRC	Vật liệu cơ bản
NSG	Vật liệu cơ bản
TNC	Vật liệu cơ bản
VKP	Vật liệu cơ bản
SIV	Vật liệu cơ bản
TRC	Vật liệu cơ bản
KHB	Vật liệu cơ bản
FCM	Vật liệu cơ bản
LCM	Vật liệu cơ bản
MSR	Vật liệu cơ bản
VPG	Vật liệu cơ bản
TVD	Vật liệu cơ bản
KSB	Vật liệu cơ bản
KSQ	Vật liệu cơ bản
HPM	Vật liệu cơ bản
TNT	Vật liệu cơ bản
DHM	Vật liệu cơ bản
TC6	Vật liệu cơ bản
NBC	Vật liệu cơ bản
MTA	Vật liệu cơ bản
CST	Vật liệu cơ bản
BMC	Vật liệu cơ bản
THT	Vật liệu cơ bản
YBM	Vật liệu cơ bản
MGC	Vật liệu cơ bản
TDN	Vật liệu cơ bản
MDC	Vật liệu cơ bản
KCB	Vật liệu cơ bản
TMB	Vật liệu cơ bản
CBI	Vật liệu cơ bản
MIC	Vật liệu cơ bản
BKC	Vật liệu cơ bản
KSV	Vật liệu cơ bản
HLC	Vật liệu cơ bản
MVB	Vật liệu cơ bản
HGM	Vật liệu cơ bản
VIM	Vật liệu cơ bản
LMC	Vật liệu cơ bản
AMC	Vật liệu cơ bản
BCB	Vật liệu cơ bản
ACM	Vật liệu cơ bản
ATG	Vật liệu cơ bản
CLM	Vật liệu cơ bản
GLC	Vật liệu cơ bản
BMJ	Vật liệu cơ bản
CMI	Vật liệu cơ bản
HUX	Vật liệu cơ bản
KSH	Vật liệu cơ bản
SQC	Vật liệu cơ bản
VCE	Vật liệu cơ bản
MIM	Vật liệu cơ bản
VBG	Vật liệu cơ bản
VDB	Vật liệu cơ bản
HPG	Vật liệu cơ bản
HSV	Vật liệu cơ bản
NKG	Vật liệu cơ bản
VGS	Vật liệu cơ bản
PAS	Vật liệu cơ bản
BCA	Vật liệu cơ bản
HSG	Vật liệu cơ bản
KVC	Vật liệu cơ bản
ITQ	Vật liệu cơ bản
TLH	Vật liệu cơ bản
BVG	Vật liệu cơ bản
TVN	Vật liệu cơ bản
SMC	Vật liệu cơ bản
TIS	Vật liệu cơ bản
NSH	Vật liệu cơ bản
SHA	Vật liệu cơ bản
POM	Vật liệu cơ bản
TNS	Vật liệu cơ bản
VCA	Vật liệu cơ bản
HMC	Vật liệu cơ bản
TKG	Vật liệu cơ bản
KKC	Vật liệu cơ bản
VIS	Vật liệu cơ bản
TKU	Vật liệu cơ bản
CKD	Vật liệu cơ bản
MEL	Vật liệu cơ bản
KMT	Vật liệu cơ bản
TTS	Vật liệu cơ bản
SSM	Vật liệu cơ bản
DTL	Vật liệu cơ bản
PEC	Vật liệu cơ bản
TDS	Vật liệu cơ bản
CKA	Vật liệu cơ bản
HLA	Vật liệu cơ bản
KLM	Vật liệu cơ bản
DFC	Vật liệu cơ bản
HMG	Vật liệu cơ bản
TMG	Vật liệu cơ bản
VDT	Vật liệu cơ bản
MC3	Vật liệu cơ bản
TNB	Vật liệu cơ bản
VGL	Vật liệu cơ bản
BKG	Vật liệu cơ bản
PRT	Vật liệu cơ bản
VID	Vật liệu cơ bản
DHC	Vật liệu cơ bản
VIF	Vật liệu cơ bản
CAP	Vật liệu cơ bản
HAP	Vật liệu cơ bản
HHP	Vật liệu cơ bản
SVT	Vật liệu cơ bản
SVI	Vật liệu cơ bản
MDF	Vật liệu cơ bản
GVT	Vật liệu cơ bản
FRC	Vật liệu cơ bản
PIS	Vật liệu cơ bản
VTQ	Vật liệu cơ bản
FRM	Vật liệu cơ bản
TQN	Vật liệu cơ bản
GAS	Các dịch vụ hạ tầng
ASP	Các dịch vụ hạ tầng
PVG	Các dịch vụ hạ tầng
PGS	Các dịch vụ hạ tầng
PCG	Các dịch vụ hạ tầng
SZE	Các dịch vụ hạ tầng
TDM	Các dịch vụ hạ tầng
BWE	Các dịch vụ hạ tầng
CNG	Các dịch vụ hạ tầng
PGC	Các dịch vụ hạ tầng
CLW	Các dịch vụ hạ tầng
DNW	Các dịch vụ hạ tầng
NBT	Các dịch vụ hạ tầng
MTG	Các dịch vụ hạ tầng
VMG	Các dịch vụ hạ tầng
MTV	Các dịch vụ hạ tầng
TDW	Các dịch vụ hạ tầng
PEG	Các dịch vụ hạ tầng
TVW	Các dịch vụ hạ tầng
HDW	Các dịch vụ hạ tầng
PGD	Các dịch vụ hạ tầng
HPW	Các dịch vụ hạ tầng
HGW	Các dịch vụ hạ tầng
PMG	Các dịch vụ hạ tầng
BWS	Các dịch vụ hạ tầng
DWS	Các dịch vụ hạ tầng
BWA	Các dịch vụ hạ tầng
SII	Các dịch vụ hạ tầng
BDW	Các dịch vụ hạ tầng
CTW	Các dịch vụ hạ tầng
TNW	Các dịch vụ hạ tầng
BGW	Các dịch vụ hạ tầng
BLU	Các dịch vụ hạ tầng
BMD	Các dịch vụ hạ tầng
BPW	Các dịch vụ hạ tầng
BLW	Các dịch vụ hạ tầng
BNW	Các dịch vụ hạ tầng
BTU	Các dịch vụ hạ tầng
CAM	Các dịch vụ hạ tầng
BRS	Các dịch vụ hạ tầng
BTW	Các dịch vụ hạ tầng
CDH	Các dịch vụ hạ tầng
CMW	Các dịch vụ hạ tầng
DNE	Các dịch vụ hạ tầng
DTB	Các dịch vụ hạ tầng
DBW	Các dịch vụ hạ tầng
DNN	Các dịch vụ hạ tầng
DWC	Các dịch vụ hạ tầng
GLW	Các dịch vụ hạ tầng
DVW	Các dịch vụ hạ tầng
GDW	Các dịch vụ hạ tầng
HAW	Các dịch vụ hạ tầng
HEP	Các dịch vụ hạ tầng
HTW	Các dịch vụ hạ tầng
KHW	Các dịch vụ hạ tầng
HFC	Các dịch vụ hạ tầng
HWS	Các dịch vụ hạ tầng
LCW	Các dịch vụ hạ tầng
LKW	Các dịch vụ hạ tầng
LAW	Các dịch vụ hạ tầng
LDW	Các dịch vụ hạ tầng
LWS	Các dịch vụ hạ tầng
MBN	Các dịch vụ hạ tầng
MLC	Các dịch vụ hạ tầng
MQN	Các dịch vụ hạ tầng
MDA	Các dịch vụ hạ tầng
MND	Các dịch vụ hạ tầng
MTL	Các dịch vụ hạ tầng
NAW	Các dịch vụ hạ tầng
MTH	Các dịch vụ hạ tầng
NAU	Các dịch vụ hạ tầng
NBW	Các dịch vụ hạ tầng
NDW	Các dịch vụ hạ tầng
NNT	Các dịch vụ hạ tầng
NQN	Các dịch vụ hạ tầng
NLS	Các dịch vụ hạ tầng
NQB	Các dịch vụ hạ tầng
NS2	Các dịch vụ hạ tầng
NSL	Các dịch vụ hạ tầng
NQT	Các dịch vụ hạ tầng
NS3	Các dịch vụ hạ tầng
NTW	Các dịch vụ hạ tầng
NUE	Các dịch vụ hạ tầng
PJS	Các dịch vụ hạ tầng
PND	Các dịch vụ hạ tầng
NVP	Các dịch vụ hạ tầng
PMW	Các dịch vụ hạ tầng
PPY	Các dịch vụ hạ tầng
PYU	Các dịch vụ hạ tầng
POV	Các dịch vụ hạ tầng
PWS	Các dịch vụ hạ tầng
QNU	Các dịch vụ hạ tầng
QNW	Các dịch vụ hạ tầng
SSU	Các dịch vụ hạ tầng
TAP	Các dịch vụ hạ tầng
SDV	Các dịch vụ hạ tầng
STW	Các dịch vụ hạ tầng
THN	Các dịch vụ hạ tầng
THW	Các dịch vụ hạ tầng
TAW	Các dịch vụ hạ tầng
THU	Các dịch vụ hạ tầng
TOW	Các dịch vụ hạ tầng
TQW	Các dịch vụ hạ tầng
UDL	Các dịch vụ hạ tầng
USD	Các dịch vụ hạ tầng
UCT	Các dịch vụ hạ tầng
UMC	Các dịch vụ hạ tầng
VCW	Các dịch vụ hạ tầng
VLW	Các dịch vụ hạ tầng
VAV	Các dịch vụ hạ tầng
VLP	Các dịch vụ hạ tầng
VPW	Các dịch vụ hạ tầng
POW	Các dịch vụ hạ tầng
GEG	Các dịch vụ hạ tầng
TTA	Các dịch vụ hạ tầng
PPC	Các dịch vụ hạ tầng
SJD	Các dịch vụ hạ tầng
VPD	Các dịch vụ hạ tầng
QTP	Các dịch vụ hạ tầng
NT2	Các dịch vụ hạ tầng
NED	Các dịch vụ hạ tầng
KHP	Các dịch vụ hạ tầng
HND	Các dịch vụ hạ tầng
VSH	Các dịch vụ hạ tầng
PGV	Các dịch vụ hạ tầng
SBA	Các dịch vụ hạ tầng
ND2	Các dịch vụ hạ tầng
DTE	Các dịch vụ hạ tầng
GHC	Các dịch vụ hạ tầng
TBC	Các dịch vụ hạ tầng
TMP	Các dịch vụ hạ tầng
BHA	Các dịch vụ hạ tầng
DTK	Các dịch vụ hạ tầng
TTE	Các dịch vụ hạ tầng
GSM	Các dịch vụ hạ tầng
HNA	Các dịch vụ hạ tầng
BTP	Các dịch vụ hạ tầng
SHP	Các dịch vụ hạ tầng
PIC	Các dịch vụ hạ tầng
HPD	Các dịch vụ hạ tầng
CHP	Các dịch vụ hạ tầng
EIC	Các dịch vụ hạ tầng
VCP	Các dịch vụ hạ tầng
NBP	Các dịch vụ hạ tầng
S4A	Các dịch vụ hạ tầng
BSA	Các dịch vụ hạ tầng
DNC	Các dịch vụ hạ tầng
AVC	Các dịch vụ hạ tầng
DNA	Các dịch vụ hạ tầng
DRL	Các dịch vụ hạ tầng
GE2	Các dịch vụ hạ tầng
DNH	Các dịch vụ hạ tầng
EAD	Các dịch vụ hạ tầng
HJS	Các dịch vụ hạ tầng
ISH	Các dịch vụ hạ tầng
QPH	Các dịch vụ hạ tầng
SBM	Các dịch vụ hạ tầng
NTH	Các dịch vụ hạ tầng
SBH	Các dịch vụ hạ tầng
SP2	Các dịch vụ hạ tầng
TDB	Các dịch vụ hạ tầng
SEB	Các dịch vụ hạ tầng
SVH	Các dịch vụ hạ tầng
XMP	Các dịch vụ hạ tầng
BSR	Dầu khí
TDG	Dầu khí
PVO	Dầu khí
PTX	Dầu khí
OIL	Dầu khí
PLX	Dầu khí
PCN	Dầu khí
PVD	Dầu khí
PVC	Dầu khí
PTV	Dầu khí
MTS	Dầu khí
PVY	Dầu khí
PVS	Dầu khí
PVB	Dầu khí
POS	Dầu khí
PEQ	Dầu khí
PSH	Dầu khí
POB	Dầu khí
SHE	Dầu khí
TLP	Dầu khí
PDT	Dầu khí